NO ./img/school/paint_wall.png
SO ./img/school/window.png
WE ./img/school/brick_wall.png
EA ./img/school/lockers.png


F 142,136,73
C 109,192,195

1111111111111
1000000000001
1000000000001
1111110000001
     10000001
11111100000011111
1001 100000000001111
111111110000000000W1
111    1111111111111