NO ./img/school/paint_wall.png
SO ./img/school/window.png
WE ./img/school/brick_wall.png
EA ./img/school/lockers.png


F 142,136,73
C 109,192,195

 111
11011
10001
10001
10001
11011
11N11
11111