EA ./img/kitchen/kitchen.png

WE ./img/kitchen/wood.png

				F 0 ,157,	255
				SO ./img/kitchen/white_brick.png

			NO ./img/kitchen/flower_pattern.png
		C 0,   				30,   90

111111111111111111111
100000000000000000001
100000000000000000001
100000000000000000001
100000000000000000001
10000000000S000000001
100000000000000000001
111111111101111111111
1111111111111111111
