NO ./img/Standard/1.png
SO ./img/Standard/2.png
WE ./img/Standard/3.png
EA ./img/Standard/4.png

F 20,20,20
C 200,200,200

11111
1KKK1
1KSK1
1KKK1
1KKK1
1KKK1
11KK1
1KKK1
1KKK1
1KKK1
1KKK1
1KKK1
11111