NO ./img/Standard/1.png
SO ./img/Standard/2.png
WE ./img/Standard/3.png
EA ./img/Standard/4.png

11111
10001
10S01
10001
100K1
10001
11001
10001
10001
10001
10001
10001
11111

F 20,20,20
C 200,200,200