NO ./img/castle/castle_brick.png
SO ./img/castle/castle_library.png
WE ./img/castle/castle_wallpaper.png
EA ./img/castle/castle_window.png

FL ./img/castle/castle_floor_carpet.png
CE ./img/castle/castle_ceiling.png

F 146,116,91
C 135,206,235


11111111111111111111111111111
11111111111111S11111111111111
11111111111110001111111111111
11111111111100000111111111111
11111110000000000000001111111
11111000000000000000000011111
11111100001111111110000111111
11111110011111111111001111111
11111110000000000000001111111
11111110011101110111001111111
11111100001100000110000111111
11111000000111311100000011111
11111100000000100000000111111
11111111111100000111111111111
11111111111110001111111111111
11111111111111011111111111111
11111111111111111111111111111