NO ./img/fire/fire_1.png
SO ./img/fire/fire_2.png
WE ./img/fire/fire_3.png
EA ./img/fire/fire_4.png

FL ./img/fire/fire_f.png
CE ./img/fire/fire_c.png

F 146,116,91
C 135,206,235

11111111111111111111111111111
11111100011111111110001111111
100000000011000W1000000000111
11001000000000011100000000111
11001000000000011100000000111
11000001111100001110000001111
11000011111000000110000000111
11000011111000000000000000111
11000000000001110110000001111
11110000000001100110000001111
11110011000001000110000001111
11000111100000001300000001111
11000110000000011100000001111
11000000000001111000000011111
11000000000011110000000111111
11000000011111100000011111111
11000111111111100011111111111
11011111111111111111111111111
11111111111111111111111111111