NO ./img/oot/forest/forest_1.png
SO ./img/oot/forest/forest_2.png
WE ./img/oot/forest/forest_3.png
EA ./img/oot/forest/forest_5.png

FL ./img/oot/forest/forest_4.png
CE ./img/oot/forest/forest_f.png

F 146,116,91
C 135,206,235

          11111111     
  11111111110000E11
11100000000001111111
10001111111111    11
1000001110011    111
 111101000000111
10011000111000001      
1011 111  11111001  
111       100000111
      11111011000011
  11111000111110011 
1110000000000000111111
1000011110111000100001
1111110000103110001101
     11111101111111101
     11110000000000001
111111  11111111111111
              11111