NO ./img/futuristic/cyberpunk_1.png
SO ./img/futuristic/matrix_1.png
WE ./img/futuristic/star_wars.png
EA ./img/futuristic/cyberpunk_2.png

FL ./img/futuristic/concrete.png
CE ./img/futuristic/stars.png

F 146,116,91
C 135,206,235

     11111
11111100011111111
100000000011000W1
11001000000000011
11001000000000011
11000001111100001111
 1100001111100000011
 1100001131100000001
 1100000000000111011
 1111000000000110011
 1111001100000100011
  110001111000000011
  110001100000000111
  11000000000001111
  1100000000001111
  110000000111111
  11000111111111
  110111
   111