NO ./img/kitchen/black_brick.png
SO ./img/kitchen/flower_pattern.png
WE ./img/kitchen/white_brick.png
EA ./img/kitchen/kitchen.png

FL ./img/kitchen/wood.png
CE ./img/concrete.png

F 146,116,91
C 135,206,235

111111
110011
130011
110S11
110011
111111