NO ./img/futuristic/cyberpunk_1.png
SO ./img/futuristic/matrix_1.png
WE ./img/futuristic/star_wars.png
EA ./img/futuristic/cyberpunk_2.png

FL ./img/futuristic/concrete.png
CE ./img/futuristic/stars.png

F 146,116,91
C 135,206,235

111  11111   11111
1S1 1100011 1100011
101 1001001 1001001
101 101 101 101 101
101 101 101 101 101 111
1001001 1001001 1001131
1100011 1100011 1100001
 11111   11111   11111
                          