NO ./img/paint_wall.png
SO ./img/window.png
WE ./img/brick_wall.png
EA ./img/lockers.png

F 142,136,73
C 109,192,195

1111111111111111
1111000000000111
110000000000W111
1110000131000011
1110000010000011
1000000000000001
1000101111110011
10000011 1000011
11111111 1111111
