NO ./img/forest/forest.png
SO ./img/forest/forest.png
WE ./img/forest/forest.png
EA ./img/forest/forest.png

FL ./img/forest/forest_ground.png
CE ./img/pokemon/pokeball.png

F 142,136,73
C 109,192,195

11111       
1E001111111 11111111
11000000001110000011111
130111110000000110000111111111
111110000011111111100011110001
1100000111        111000011111
10000111           1100111
11100001111         1000111
1111100000111111   111000011
  11000111111       1000111
   1110001111        1000011
1111100000001111    110011
  1111000011111      10000111
   11100000001111  111100001
  1111111000111111100000011
    111111000000000001111
	    1111111111111111
