NO ./img/eagle.png
SO ./img/pikachu.png
WE ./img/wood.png
EA ./img/bluestone.png

F 142,136,73
C 109,192,195

11111
1E001
11011
11011
11111
