NO ./img/water/water_5.png
SO ./img/water/water_2.png
WE ./img/water/water_3.png
EA ./img/water/water_4.png

FL ./img/water/water_f.png
CE ./img/water/water_c.png

F 146,116,91
C 135,206,235

11111111111
10000000E11
10000011111111111
10000000000000011
10001111111110011
100011     130011
10001111111110011
10000000000000011
11110111110111111
11 10000000111111
11 1111111111
