EA 					./src/Textu				res/E.png


				SO ./src/Textures/S.png
WE ./src/Tex				tures/W.png

			NO ./src/					Textures/N.png


F 77,92,53
C 163,208,230


11111111
10000001
1000W001
10000001
11111111
