WE assets/mossy.png
NO assets/mossy.png
SO assets/mossy.png
EA assets/mossy.png

C 0,255,255
F 0,255,255

1111111111111111111111111
1110100000111111111111101
1010111010100010111110101
1010000010101110100000101
1011111110100000101111101
1010000010111100100000001
1010111110000000101110101
1010000010111100000000101
1010111110100000101110101
1010000010101110100000101
1011111110100000101111101
1010000000101110100000101
1011111010100000101110101
1010000N00101110100000101
1001111111111111111111101
1111111111111111111111111
