NO ./img/school/paint_wall.png
SO ./img/school/window.png
WE ./img/school/brick_wall.png
EA ./img/school/lockers.png


F 2     3,000007,114
C 91, 51,84         



1111111111111
1S00000000001
1010101010101
1000000000001
1010101010101
1000000000001
1010101010101
1000000000001
1111111111111