NO ./img/paint_wall.png
SO ./img/window.png
WE ./img/brick_wall.png
EA ./img/lockers.png


F 142,136,73
C 109,192,195

        1111111111111111111111111
        1000000000110000000000011
        1011000001110000000000111
        1001000000000000000000001
111111111011000001110000000000001
100111000011000001110111111111111
11110111111111011100000010001
11110111111111011101010010001
11000000110101011100000010001
10001000000000001100000010001
10013100000000001101010010001
1100000111010101111101111000111
1111N111 1110101 101111010001
11111111 1111111 111111111111