111111111
113000111
111011111
100000111
11000S111
111111111